RFSweeper	KEYWORD1
begin	KEYWORD2
scanSpectrum	KEYWORD2
startJammer	KEYWORD2
stopJammer	KEYWORD2
handleJammer	KEYWORD2
isJamming	KEYWORD2
getModeString	KEYWORD2
JammingMode	KEYWORD2
JammingTechnique	KEYWORD2
IDLE    LITERAL1
WIFI	LITERAL1
BLE_ADVERTISING	LITERAL1
BLUETOOTH	LITERAL1
USB_WIRELESS	LITERAL1
VIDEO_STREAM	LITERAL1
RC_TOYS	LITERAL1
FULL_SPECTRUM	LITERAL1
SINGLE_CHANNEL	LITERAL1
CHANNEL_FLOOD_CUSTOM	LITERAL1
CONSTANT_CARRIER	LITERAL1
NOISE_INJECTION	LITERAL1